@@@@@@@@@@
@        @
@ @@ @ @ @
@ @  @ @ @
@ @@ @ @ @
@ !@   @ @
@@@@@@@@O@
